Stats_LLENEMY_Boost_Armor_5	Armor Boost
Stats_LLENEMY_Boost_Armor_10	Armor Boost
Stats_LLENEMY_Boost_Armor_15	Armor Boost
Stats_LLENEMY_Boost_Armor_20	Armor Boost
Stats_LLENEMY_Boost_Armor_25	Armor Boost
Stats_LLENEMY_Boost_Armor_30	Armor Boost
Stats_LLENEMY_Boost_Armor_35	Armor Boost
Stats_LLENEMY_Boost_Armor_40	Armor Boost
Stats_LLENEMY_Boost_Armor_45	Armor Boost
Stats_LLENEMY_Boost_Armor_50	Armor Boost
Stats_LLENEMY_Boost_Damage_5	Damage Boost
Stats_LLENEMY_Boost_Damage_10	Damage Boost
Stats_LLENEMY_Boost_Damage_15	Damage Boost
Stats_LLENEMY_Boost_Damage_20	Damage Boost
Stats_LLENEMY_Boost_Damage_25	Damage Boost
Stats_LLENEMY_Boost_MagicArmor_5	Magic Armor Boost
Stats_LLENEMY_Boost_MagicArmor_10	Magic Armor Boost
Stats_LLENEMY_Boost_MagicArmor_15	Magic Armor Boost
Stats_LLENEMY_Boost_MagicArmor_20	Magic Armor Boost
Stats_LLENEMY_Boost_MagicArmor_25	Magic Armor Boost
Stats_LLENEMY_Boost_MagicArmor_30	Magic Armor Boost
Stats_LLENEMY_Boost_MagicArmor_35	Magic Armor Boost
Stats_LLENEMY_Boost_MagicArmor_40	Magic Armor Boost
Stats_LLENEMY_Boost_MagicArmor_45	Magic Armor Boost
Stats_LLENEMY_Boost_MagicArmor_50	Magic Armor Boost
Stats_LLENEMY_Boost_Vitality_5	Vitality Boost
Stats_LLENEMY_Boost_Vitality_10	Vitality Boost
Stats_LLENEMY_Boost_Vitality_15	Vitality Boost
Stats_LLENEMY_Boost_Vitality_20	Vitality Boost
Stats_LLENEMY_Boost_Vitality_25	Vitality Boost
Stats_LLENEMY_Boost_Vitality_30	Vitality Boost
Stats_LLENEMY_Boost_Vitality_35	Vitality Boost
Stats_LLENEMY_Boost_Vitality_40	Vitality Boost
Stats_LLENEMY_Boost_Vitality_45	Vitality Boost
Stats_LLENEMY_Boost_Vitality_50	Vitality Boost
Stats_LLENEMY_Infusion_Acid_G	Elite Acid Infusion
Stats_LLENEMY_Infusion_Blessed_Ice_G	Elite Blessed Ice Infusion
Stats_LLENEMY_Infusion_Blood_G	Elite Blood Infusion
Stats_LLENEMY_Infusion_Cursed_Electric_G	Elite Cursed Electric Infusion
Stats_LLENEMY_Infusion_Electric_G	Elite Electric Infusion
Stats_LLENEMY_Infusion_Fire_G	Elite Fire Infusion
Stats_LLENEMY_Infusion_Necrofire_G	Elite Necrofire Infusion
Stats_LLENEMY_Infusion_Oil_G	Elite Oil Infusion
Stats_LLENEMY_Infusion_Poison_G	Elite Poison Infusion
Stats_LLENEMY_Infusion_Water_G	Elite Water Infusion
Stats_LLENEMY_RangerRange	Talent: Quickdraw
Stats_LLENEMY_Talent_LightningRod	Talent: Lightning Rod
Stats_LLENEMY_Talent_NaturalConductor	Talent: Natural Conductor
Stats_LLENEMY_Talent_Unstable	Talent: Unstable
Stats_LLENEMY_Talent_Weatherproof	Talent: Weatherproof